11111111111111111
10010000000000001
10000111110000001
10001110000000001
11110000000000001
1000P011111101001
10000000100001E00
1111111110001C001
10000E00000000001
11111111111111111