11111111111111
10011C10000C01
10000111110001
10P011E0000001
10000000000001
11111111111111
