11111111111111
10010C00001C01
1000E111110001
1P001100000001
10001000000001
11111111111111
