11111111111111
10011C00000C01
10000111110001
10P011E0000001
10001000000001
11111111111111
