11111111111111
10010C00000C01
10000111110001
100011P1000001
10000010000001
11111111111111
