       1
	  101
	 10001
	100P001
   100C00001
  100E0000001
 1000000000001
111111111111111
